20 20
+ ++++++++++++++++++
+          +  ++ +++
+++ ++++++   ++   ++
+ +++    +++    ++++
+   + ++ ++++++    +
+++   ++     ++ ++ +
+   +++ ++++ ++ ++ +
+ ++++  ++   +++++ +
+    + +++ +++     +
+ ++ + +++ ++++++ ++
+  +++++   +++    ++
+ +++    ++++  ++ ++
+   ++++      +++  +
+++    +++++++++++ +
++  +++++++        +
++ +++    ++++++++ +
++ ++++++        + +
+    +++  ++++++ +++
++++     +++     +++
+++++++++++++ ++++++